11111111111111111111
10001100000000100011
1111C000000000100001
1000111000E000100001
11100000000001100011
10000000000000100001
10001010000000000001
1000001000P000110101
10000000000000101101
10000000000011100001
11111111111111111111
