11111111111111111111
100000P00000CE100011
11100000000000100001
10000010000000100001
11100000000001110001
10000000000001100001
10001010000100100001
10000010000000100001
10000000000000000101
10000000000011000001
11111111111111111111
