111111111111111
1000P0000000011
111000000C00011
100000100000001
111111111111111
