11111111111111111111
1000P000000000000001
1110000CE00000000001
10000010000000100001
11100000000001110001
10000000000001000001
10001010000100000001
10000010000000000001
10000000000000000001
10000000000011000001
11111111111111111111
