11111111111111111111
1000P00000000C100001
1110000C00000010C001
10000010000000100001
11100000000001110001
10000000000001100001
10001010000100100001
10000010000000100001
1000000C0000C0000001
100000000000110000E1
11111111111111111111
